#################
#               #
# ## ## # ## ## #
#               #
# ## # ### # ## #
#    #  #  #    #
#### ## # ## ####
   # #     # #   
#### # ### # ####
#      # #
#
#
#
#
#
#
#
#
#
#
#
#