###################
#        #        #
# ## ### # ### ## #
#                 #
# ## # ##### # ## #
#    #   #   #    #
#### ### # ### ####
#..# #       # #..#
#### # ##.## # ####
<      #...#      >
#### # ##### # ####
#..# #       # #..#
#### # ##### # ####
#        #        #
# ## ### # ### ## #
#  #           #  #
## # # ##### # # ##
#    #   #   #    #
# ###### # ###### #
#                 #
###################