###################
#        #        #
# ## ### # ### ## #
#                 #
# ## # ##### # ## #
#    #   #   #    #
#### ### # ### ####
   # #       # #  
#### # ## ## # ####
       #   #  
#### # ##### # #### 
   # #       # # 
####           ####    
#               
#               
#               
#               
#               
#               
#               
#
#
##################