###################
#        #        #
# ## ### # ### ## #
# ## ### # ### ## #
#                 #
# ## #  ###  # ## #
#    ##  #  ##    #
###################