#################
# ## ## # ## ## #
#
# ## # ### # ## #
#    #  #  #    #
#### ## # ## ####
#### #     # ####
#### # ### # ####
#      # #
#
#
#
#
#
#
#
#
#
#
#
#