###################
#        #        #
# ## ### # ### ## #
# ## ### # ### ## #
#                 #
# ## #  ###  # ## #
#    ##  #  ##    #
#    #       #    #
#       # #       #
#       ###       #
#                 #
###################