###################
#        #        #
# ## ### # ### ## #
#                 #
# ## # ##### # ## #
#    #   #   #    #
#### ### # ### ####
   # #       # #  
#### # ## ## # ####
       #   #  
#### # ##### # #### 
   # #       # # 
#### # ##### # ####    
#        #        #
# ## ### # ### ## #    
#  #           #  #
## # # ##### # # ##
#    #   #     #  #
# ###### # ###### #      
#                 #
###################