#################
#       #       #
# ## ## # ## ## #
# ## ## # ## ## #
#               #
# ## # ### # ## #
#    ## # ##    #
#################